###############################################################################
#       ^^                                                                    #
# *****  ^^                                                                   #
# * ☺ *                                                                       #
# *   *                                                                       #
# **/**                                                                       #
#                                                                             #
#     AAA                                                                     #
#    AAAAA                                                                    #
#    AAAAAA                                                                   #
#    AAAAAA                                                                   #
#      AAAA                                                                   #
#                                                                             #
#                                                                             #
#                                                                             #
#                                                                             #
#                                                                             #
#                                                                             #
#                                                                             #
#                                                                             #
#                                                                             #
#                                                                             #
#                                                                             #
#                                                                             #
#                                                                             #
#                                                                             #
#                                                                             #
#                                                                             #
#                                                                             #
#                                                                             #
#                                                                             #
#                                                                             #
#                                                                             #
#                                                                             #
#                                                                             #
#                                                                             #
#                                                                             #
#                                                                             #
#                                                                             #
###############################################################################