###############################################################################
#                                                                             #
#     *******                                                                 #
#     *     *                                                                 #
#     *     *                                                                 #
#     ***;***                                                                 #
#                                                                             #
#-------------------------                      ------                        #                               #
#                         ---                  --                             #
#                            --               --                              #
#                              -             --                               #
#                               -           --                                #
#                                -         --                                 #
#                                 ---------                                   #
#                                 -                                           #
#                                 -                                           #
#                                                                             #
#                                                                             #
#                                                                             #
#                                                                             #
#                                                                             #
#                                                                             #
#                                                                             #
#                                                                             #
#                                                                             #
#                                                                             #
#                                                                             #
#                                                                             #
#                                                                             #
#                                                                             #
#                                                                             #
#                                                                             #
#                                                                             #
#                                                                             #
#                                                                             #
#                                                                             #
#                                                                             #
#                                                                             #
#                                                                             #
###############################################################################