###############################################################################
#                                                                             #
#     *******                                                                 #
#     *     *                                                                 #
#     *     *                                                 *****           #
#     ***;***                                                 *   *           #
#                                                             *   *           #
#-------------------------                      -----------   ;   *           #                               #
#                         ---                  --             *   *           #
#                            --               --              *   *           #
#                              -             --               *****           #
#                               -           --                                #
#                                -         --                                 #
#                                 ---------                                   #
#                                 -                                           #
#                                 -                                           #
#                                 -                                           #
#                                -                                            #
#                                -                                            #
#              ~~~~~~~~~         -                                            #
#  ~~~~~~~~~~~~         ~~~~     -    ~~~~~~~~~~~~~~~                         #
#~~                         ~~~~~=~~~~               ~~~~~~~~~~~~             #
#                                -                               ~~~~~~~~~~~~ #
#                                -                                            #
#                                -                                            #
#                                -                                            #
#                                -                                            #
#                                -                                            #
#                            -----                                          ^ #
#                           -    --                                           #
#                           -       -                                       ^ #
#                          -       -                                          #
#                          -        ----------------------------------------  #
#                  --------                                              ^    #
#                                                                          ^  #
#                                                                           ^ #
#                                                                           ^ #
#                                                                             #
#                                                                             #
###############################################################################